11111111111111111111111111111111
10000000000000000000000000000001
10000000000000000000000000000001
10000000000000000000000000000001
1P00000000000C0000000000000000E1
11111111111111111111111111111111
