111111111111111111
10010000000C00E0C1
100001111111110001
1P00110000000000C1
111111111111111111
