111111111111111111
10010000000C0000C1
100001111111110001
1P0011E000000000C1
111111111111111111
